6
14
14
##############
#  *  *      #
#  # B # O   #
#        *   #
#   #O#      #
# bp     #   #
#  xf    O   #
# #   #  *   #
#   #s   #   #
#   B        #
#  # *  #    #
#    O       #
#    #   # B #
##############