7
15
15
###############
#  *  *       #
#  # B # O    #
#        *    #
#   #O#       #
# bp     #    #
#  xf    O    #
# #   #  *    #
#   #s   #    #
#   B         #
#  # *  #     #
#    O        #
#    #   # B  #
#  O * O *  B #
###############