9
17
17
#################
#  *  *         #
#  # B # O      #
#        *      #
#   #O#     O   #
# bp     #      #
#  xf    O  #   #
# #   #  *      #
#   #s   #      #
#   B           #
#  # *  #   *   #
#    O          #
#    #   # B    #
#  O * O *  B   #
#  b #    f  #  #
#    s *  s O   #
#################