8
16
16
################
#  *  *        #
#  # B # O     #
#        *     #
#   #O#        #
# bp     #     #
#  xf    O     #
# #   #  *     #
#   #s   #     #
#   B          #
#  # *  #      #
#    O         #
#    #   # B   #
#  O * O *  B  #
#  b #    f  # #
################