4
12
12
############
#          #
#  # B#    #
#          #
#   #O#    #
# b     p  #
#   f      #
# #   #    #
#   #s   # #
#x  B  B   #
#          #
############